As of March 28, 2020, a total of 571,678 confirmed COVID-19 cases and 26,494 deaths have been reported worldwide.	Al 28 marzo 2020, sono stati registrati un totale di 571.678 casi confermati di COVID-19 e 26.494 decessi in tutto il mondo.	training_en
U.S. older adults, including those aged ≥65 years and particularly those aged ≥85 years, also appear to be at higher risk for severe COVID-19–associated outcomes; however, data describing underlying health conditions among U.S. COVID-19 patients have not yet been reported."	Anche gli adulti anziani statunitensi, inclusi quelli di età ≥65 anni e in particolare quelli di età ≥85 anni sembrano essere a maggior rischio di complicanze gravi associate al COVID-19; tuttavia, non sono ancora stati riportati dati che descrivano le patologie pregresse nei pazienti COVID-19 negli Stati Uniti.	training_en
As of March 28, 2020, U.S. states and territories have reported 122,653 U.S. COVID-19 cases to CDC, including 7,162 (5.8%) for whom data on underlying health conditions and other known risk factors for severe outcomes from respiratory infections were reported.	Al 28 marzo 2020, gli stati federati e i territori degli Stati Uniti hanno segnalato ai CDC 122.653 casi di COVID-19 negli Stati Uniti, compresi 7.162 (5,8%) per i quali erano riportati i dati su patologie pregresse e altri fattori di rischio noti per complicanze gravi da infezioni respiratorie.	training_en
The most commonly reported conditions were diabetes mellitus, chronic lung disease, and cardiovascular disease.	Le patologie segnalate più comunemente erano diabete mellito, malattie polmonari croniche e malattie cardiovascolari.	training_en
Data from laboratory-confirmed COVID-19 cases reported to CDC from 50 states, four U.S. territories and affiliated islands, the District of Columbia, and New York City with February 12–March 28, 2020 onset dates were analyzed.	Sono stati analizzati i dati provenienti da casi di COVID-19 confermati in laboratorio segnalati ai CDC da 50 stati, quattro territori e isole affiliate degli Stati Uniti, il District of Columbia e New York, aventi come data di insorgenza il periodo 12 febbraio - 28 marzo 2020.	training_en
Cases among persons repatriated to the United States from Wuhan, China, and the Diamond Princess cruise ship were excluded.	Sono stati esclusi i casi di persone rimpatriate negli Stati Uniti da Wuhan o dalla nave da crociera Diamond Princess.	training_en
Data reported to CDC are preliminary and can be updated by health departments over time; critical data elements might be missing at the time of initial report; thus, this analysis is descriptive, and no statistical comparisons could be made.	I dati riportati ai CDC sono preliminari e possono essere aggiornati nel tempo dai dipartimenti sanitari; alcuni dati essenziali potrebbero essere assenti al momento della stesura del report iniziale; pertanto, questa analisi è descrittiva, e non è stato possibile effettuare comparazioni statistiche.	training_en
Percentages of hospitalizations with and without ICU admission were estimated for persons aged ≥19 years with and without underlying health conditions.	Sono state stimate le percentuali delle ospedalizzazioni con e senza ricovero in UTI per le persone di età ≥19 anni con e senza patologie pregresse.	training_en
This part of the analysis was limited to persons aged ≥19 years because of the small sample size of cases in children with reported underlying health conditions (N = 32).	Questa parte dell’analisi è stata limitata alle persone di età ≥19 anni per via della ridotta dimensione del campione dei casi in bambini con patologie pregresse segnalate (N = 32).	training_en
As of March 28, 2020, a total of 122,653 laboratory- confirmed COVID-19 cases (Figure) and 2,112 deaths were reported to CDC.	Al 28 marzo 2020 sono stati segnalati ai CDC un totale di 122.653 casi di COVID-19 confermati in laboratorio, e 2.112 decessi.	training_en
Data on presence or absence of underlying health conditions and other recognized risk factors for severe outcomes from respiratory infections (i.e., smoking and pregnancy) were available for 7,162 (5.8%) patients (Table 1).	I dati sulla presenza o sull’assenza di patologie pregresse e altri fattori di rischio riconosciuti per complicanze gravi da infezioni respiratorie (ossia fumo e gravidanza) erano disponibili per 7.162 (5,8%) pazienti (Tabella 1).	training_en
Approximately one third of these patients (2,692, 37.6%), had at least one underlying condition or risk factor.	Circa un terzo di questi pazienti (1.692, 37,6%), era affetto almeno da una patologia pregressa o un fattore di rischio.	training_en
In contrast, 1,388 of 5,143 (27%) COVID-19 patients who were not hospitalized were reported to have at least one underlying health condition.	Al contrario, è stato riscontrato che 1.388 su 5.143 (27%) pazienti COVID-19 non ospedalizzati avessero almeno una patologia pregressa.	training_en
Small numbers of COVID-19 patients aged <19 years were reported to be hospitalized or admitted to an ICU (eight).	Sono stati riscontrati numeri esigui di pazienti COVID-19 di età <19 anni ospedalizzati o ricoverati in UTI (otto).	training_en
In contrast, 335 patients aged <19 years were not hospitalized and 1,342 had missing data on hospitalization.	Per contro, 335 pazienti di età <19 anni non sono stati ospedalizzati e 1.342 non avevano dati sull’ospedalizzazione.	training_en
These results are consistent with findings from China and Italy, which suggest that patients with underlying health conditions and risk factors, including, but not limited to, diabetes mellitus, hypertension, COPD, coronary artery disease, cerebrovascular disease, chronic renal disease, and smoking, might be at higher risk for severe disease or death from COVID-19.	Tali risultati sono in linea con quelli riscontrati in Cina e in Italia, che suggeriscono che i pazienti affetti da patologie pregresse e fattori di rischio, inclusi (ma non limitati a) diabete mellito, ipertensione, BPCO, coronaropatia, malattie cerebrovascolari, malattie renali croniche e fumo, siano a maggior rischio di malattia grave o decesso da COVID-19.	training_en
It is not yet known whether the severity or level of control of underlying health conditions affects the risk for severe disease associated with COVID-19.	Non è ancora noto se la gravità o il livello di controllo delle patologie pregresse influisca sul rischio di malattia grave associata al COVID-19.	training_en
Many of these underlying health conditions are common in the United States: based on self-reported 2018 data, the prevalence of diagnosed diabetes among U.S. adults was 10.1%, and the U.S. age-adjusted prevalence of all types of heart disease (excluding hypertension without other heart disease) was 10.6% in 2017.	Molte di queste patologie pregresse sono diffuse negli Stati Uniti: stando ai dati auto-riferiti del 2018, la prevalenza del diabete diagnosticato negli adulti negli Stati Uniti era del 10,1%, e la prevalenza aggiustata per età per tutti i tipi di malattia cardiaca (eccetto l’ipertensione in assenza di altre malattie cardiache) era del 10,6% nel 2017.	training_en
The estimated higher prevalence of these conditions among those in this early group of U.S. COVID-19 patients and the potentially higher risk for more severe disease from COVID-19 associated with the presence of underlying conditions highlight the importance of COVID-19 prevention in persons with underlying conditions.	La maggiore prevalenza stimata di queste patologie tra coloro che compongono questo gruppo iniziale di pazienti COVID-19 negli Stati Uniti e il maggiore rischio di sviluppare forme più gravi di COVID-19 associate alla presenza di patologie pregresse pone in risalto l’importanza della prevenzione del COVID-19 nelle persone affette da patologie pregresse.	training_en
First, these data are preliminary, and the analysis was limited by missing data related to the health department reporting burden associated with rapidly rising case counts and delays in completion of information requiring medical chart review; these findings might change as additional data become available.	In primo luogo, questi dati sono preliminari, e l’analisi è stata limitata dalla mancanza di dati dovuta all’onere di segnalazione dei dipartimenti sanitari associato al rapido aumento del conteggio dei casi e ai ritardi nel completamento delle informazioni richiedenti la revisione delle cartelle cliniche; tali risultati potrebbero cambiare quando saranno disponibili ulteriori dati.	training_en
Information on underlying conditions was only available for 7,162 (5.8%) of 122,653 cases reported to CDC.	Le informazioni sulle patologie pregresse erano disponibili solo per 7.162 (5,8%) dei 122.653 casi segnalati ai CDC.	training_en
Some outcomes might be underestimated, and long-term outcomes cannot be assessed in this analysis.	Alcuni risultati potrebbero essere sottostimati, e non è possibile valutare gli esiti clinici a lungo termine in questa analisi.	training_en
Fourth, because of the descriptive nature of these data, attack rates among persons with and without underlying health conditions could not be compared, and thus the risk difference of severe disease with COVID-19 between these groups could not be estimated.	In quarto luogo, per via della natura descrittiva dei dati, non è stato possibile comparare i tassi d’attacco nelle persone affette da e prive di patologie pregresse, e non è stato quindi possibile stimare la differenza di rischio di malattia grave da COVID-19 tra questi gruppi.	training_en
Fifth, no conclusions could be drawn about underlying conditions that were not included in the case report form or about different conditions that were reported in a single, umbrella category.	In quinto luogo, non è stato possibile trarre conclusioni sulle patologie pregresse non comprese nei moduli di segnalazione o su patologie differenti che sono state riportate in una singola categoria più ampia.	training_en
Persons in the United States with underlying health conditions appear to be at higher risk for more severe COVID-19, consistent with findings from other countries.	Le persone negli Stati Uniti affette da patologie pregresse risultano essere a maggior rischio di forme più gravi di COVID-19, il che è conforme ai risultati provenienti da altri Paesi.	training_en
These persons should take steps to protect themselves from COVID-19, through washing their hands; cleaning and disinfecting high-touch surfaces; and social distancing, including staying at home, avoiding crowds, gatherings, and travel, and avoiding contact with persons who are ill.	Queste persone dovrebbero adottare misure per proteggersi dal COVID-19, lavandosi le mani, pulendo e disinfettando superfici ad alto contatto, e tramite il distanziamento sociale, che comprende rimanere a casa, evitare le folle, gli assembramenti e i viaggi, ed evitare il contatto con persone malate.	training_en
Maintaining at least a 30-day supply of medication, a 2-week supply of food and other necessities, and knowledge of COVID-19 symptoms are recommended for those with underlying health conditions.	A chi è affetto da patologie pregresse si raccomanda di mantenere una scorta di medicinali per almeno 30 giorni e una scorta di cibo e di altri beni di prima necessità per almeno due settimane, e di restare informati sui sintomi del COVID-19.	training_en
This is especially important for those who work with persons with underlying conditions or who otherwise are at high risk for severe outcomes from COVID-19.	Ciò è particolarmente importante per chi lavora con persone affette da patologie pregresse o chi è comunque ad alto rischio di complicanze gravi da COVID-19.	training_en
What is already known about this topic?	Cosa si sa già sull’argomento?	training_en
Published reports from China and Italy suggest that risk factors for severe COVID-19 disease include underlying health conditions, but data describing underlying health conditions among COVID-19 patients have not yet been reported.	I report pubblicati in Cina e in Italia suggeriscono che i fattori di rischio per malattia grave da COVID-19 comprendono condizioni pregresse, ma non sono stati ancora riportati dati sulle patologie pregresse tra i pazienti COVID-19 negli Stati Uniti.	training_en
What are the implications for public health practice?	Quali sono le implicazioni per le pratiche di sanità pubblica?	training_en
The outbreak of Coronavirus disease 2019 (COVID-19), caused by severe acute respiratory syndrome (SARS) coronavirus 2 (SARS-CoV-2), has thus far killed over 3,000 people and infected over 80,000 in China and elsewhere in the world, resulting in catastrophe for humans.	L’epidemia di malattia da Coronavirus 19 (COVID-19), causata dal coronavirus 2 da sindrome respiratoria acuta grave (SARS-CoV-2), ha causato finora la morte di 3.000 persone e ne ha infettate oltre 80.000 in Cina e in altre parti del mondo, generando una catastrofe per gli esseri umani.	training_en
Similar to its homologous virus, SARS-CoV, which caused SARS in thousands of people in 2003, SARS-CoV-2 might also be transmitted from the bats and causes similar symptoms through a similar mechanism.	Simile al suo virus omologo, il SARS-CoV, che provocò la SARS in migliaia di persone nel 2003, il SARS-CoV-2 potrebbe essere trasmesso anch’esso dai pipistrelli e causa sintomi analoghi attraverso un meccanismo analogo.	training_en
We will cover the basics about the epidemiology, etiology, virology, diagnosis, treatment, prognosis, and prevention of the disease.	Verranno trattati gli aspetti di base dell’epidemiologia, l’eziologia, la virologia, la diagnosi, il trattamento, la prognosi e la prevenzione della malattia.	training_en
The Spring Festival on January 25, 2020 has become an unprecedented and unforgettable memory to all Chinese who were urged to stay indoors for all the holiday and for many weeks after due to the outbreak of a novel viral disease.	La Festa di Primavera del 25 gennaio 2020 è diventata un ricordo indelebile per tutti i cinesi che sono stati esortati a rimanere in casa per tutta la festività e per molte settimane successive, a causa dell’epidemia di una nuova malattia virale.	training_en
The virus is highly homologous to the coronavirus (CoV) that caused an outbreak of severe acute respiratory syndrome (SARS) in 2003; thus, it was named SARS-CoV-2 by the World Health Organization (WHO) on February 11, 2020, and the associated disease was named CoV Disease-19 (COVID-19).	Il virus è altamente omologo al coronavirus (CoV) che provocò nel 2003 un’epidemia di sindrome respiratoria acuta grave (SARS); pertanto, l’11 febbraio 2020 è stato denominato SARS-CoV-2 dall’Organizzazione Mondiale della Sanità (OMS), e la malattia ad esso associata è stata chiamata CoV Disease-19 (COVID-19).	training_en
WHO warns that COVID-19 is “public enemy number 1” and potentially more powerful than terrorism.	L’OMS avverte che il COVID-19 è il “pericolo pubblico numero 1” e che è potenzialmente più potente del terrorismo.	training_en
This review attempts to summarize the research progress in the new and swiftly developing subject area.	La presente rassegna tenterà di riassumere il progresso della ricerca in questa nuova area in rapida evoluzione.	training_en
Whenever possible, we will try to compare COVID-19 with SARS and another CoV-caused disease, Middle East respiratory syndrome (MERS, an outbreak in 2012).	Ove possibile, si tenterà di confrontare il COVID-19 con la SARS e un’altra malattia causata da un CoV, la sindrome respiratoria mediorientale (MERS, un’epidemia del 2012).	training_en
However, in this century, we have encountered highly pathogenic human CoVs twice, i.e., SARS-CoV and MERS-CoV, which caused an outbreak originally in China in 2003 and Saudi Arabia in 2012, respectively, and soon spread to many other countries with horrible morbidity and mortality.	Tuttavia, in questo secolo abbiamo incontrato due volte CoV umani altamente patogeni, ossia il SARS-CoV e il MERS-CoV, che in origine hanno provocato rispettivamente un’epidemia in Cina nel 2003 e in Arabia Saudita nel 2012, e si sono presto diffusi in altri paesi con morbilità e mortalità terribili.	training_en
As shown in Fig. 1, clusters of pneumonia that had unknown origins were first reported from Wuhan on December 31, 2019 to the China National Health Commission.	Come illustrato dalla Fig. 1, i cluster di polmonite di origine ignota sono stati segnalati a Wuhan per la prima volta il 31 dicembre 2019 alla Commissione nazionale di sanità cinese.	training_en
Seven days later the sequence of the CoV was released.	Sette giorni dopo è stata pubblicata la sequenza del CoV.	training_en
On January 20, the infection of health-care providers was reported, suggesting that human-to-human transmission was possible.	Il 20 gennaio è stata segnalata l’infezione di fornitori di cure mediche, il che ha suggerito la possibilità di una trasmissione uomo-uomo.	training_en
On January 24 the first clinical study on the disease reported that, out of 41 patients with confirmed cases, only 21 had direct contact with the Wuhan seafood market that was considered the starting site of the infection from an unknown animal source.	Il 24 gennaio, il primo studio clinico sulla malattia ha riferito che, su 41 pazienti con casi confermati, solo 21 erano venuti a contatto diretto con il mercato del pesce di Wuhan, considerato il luogo di origine dell’infezione da una fonte animale sconosciuta.	training_en
On January 30, WHO declared the outbreak a global health emergency.	Il 30 gennaio, l’OMS ha dichiarato l’epidemia un’emergenza sanitaria globale.	training_en
On February 11, 2020, a multi-center study on 8,866 patients including 4,021 confirmed COVID-19 patients presented a more updated illustration of the epidemic as follows (https://mp.weixin.qq.com/s/ UlBi-HX_rHPXa1qHA2bhdA).	L’11 febbraio 2020, uno studio multicentrico su 8.866 pazienti che ha compreso 4,021 pazienti COVID-19 confermati, presentava la seguente illustrazione più aggiornata dell’epidemia (https://mp.weixin.qq.com/UlBi-HX_rHPXa1qHA2bhdA).	training_en
Almost half (47.7%) of the infected individuals were over 50 years old, very few were under 20, and only 14 infected individuals were under the age of 10.	Circa la metà (47,7%) degli individui infetti aveva più di 50 anni, pochissimi ne avevano meno di 20, e solo 14 avevano meno di 10 anni.	training_en
SARS-CoV-2 infected more men (0.31/100,000) than women (0.27/100,000).	Il SARS-CoV-2 ha infettato più gli uomini (0,31/100.000) che le donne (0,27/100.000).	training_en
The average incubation period was 4.8 (3.0-7.2) days.	Il periodo di incubazione medio era di 4,8 (3,0-7,2) giorni.	training_en
The basic reproductive number (R0) was 3.77 (95% CI: 3.51-4.05), and the adjusted R0 was 2.23-4.82.	Il numero di riproduzione di base (R0) era di 3,77 (95%: CI: 3,51-4,05), e il R0 aggiustato era di 2,23-4,82.	training_en
The number of infected people increased exponentially before 23 Jan. 2020, matching the time of massive transportation before the Spring Festival in China.	Il numero di persone infette è aumentato esponenzialmente prima del 23 gennaio 2020, coincidendo con il periodo di traffico massiccio prima della festa di primavera in Cina.	training_en
CoVs are a subfamily of large and enveloped viruses containing a single strand of sense RNA.	I CoV sono una sottofamiglia di grandi virus capsulati contenenti un unico di filamento di RNA a senso.	training_en
The envelope spike (S) glycoprotein binds to its cellular receptors angiotensin-converting enzyme 2 (ACE2) and dipeptidyl peptidase 4 (DPP4) for SARS-CoV and MERS-CoV, respectively, and then membrane fusion occurs.	La glicoproteina spike (S) del capside si lega ai suoi recettori cellulari dell’enzima 2 convertitore dell’angiotensina (ACE2) e della dipeptidil-peptidasi IV (DPP-4), rispettivamente per il SARS-CoV e il MERS-CoV, dopodiché si verifica la fusione delle membrane.	training_en
The viral RNA genome is released into the cytoplasm; after replication of the viral genome, genomic RNA accompanied by envelope glycoproteins and nucleocapsid proteins forms virion-containing vesicles, which then fuse with the plasma membrane to release the virus.	Il genoma dell’RNA virale è rilasciato nel citoplasma; dopo la replicazione del genoma virale, l’RNA genomico, insieme alle glicoproteine del capside e alle proteine nucleocapside, forma vescicole contenenti virioni, che poi si fondono con la membrana plasmatica per rilasciare il virus.	training_en
SARS-CoV-2 is genetically more similar to SARS-CoV than to MERS-CoV.	Dal punto di vista genetico, il SARS-CoV-2 è più simile al SARS-CoV che al MERS-CoV.	training_en
Human ACE2 was found to be a receptor for SARS-CoV-2 as well as SARS-CoV.	È stato riscontrato che l’ACE2 umano è un recettore per il SARS-CoV-2, così come per il SARS-CoV.	training_en
However, the S protein of SARS-CoV-2 binds to human ACE2 more weakly than that of SARS-CoV, which is coincident with the fact that SARS-CoV-2 causes less severe infection in patients than SARS-CoV.	Tuttavia, la proteina S del SARS-CoV-2 si lega all’ACE2 umano più debolmente del SARS-CoV, il che coincide con il fatto che il SARS-CoV-2 causi infezioni meno gravi nei pazienti rispetto al SARS-CoV.	training_en
On February 18, 2020, Zhou, et al., reported the cryo-EM structure of the full-length human ACE2 at 2.9 Å resolution in complex with the amino acid transporter B0AT1.	Il 18 febbraio 2020, Zhou, et al. hanno pubblicato la struttura a crioscopia elettronica dell’ACE2 umano in tutta la sua lunghezza a risoluzione a 2,9 Å in complesso con il trasportatore di aminoacidi B0AT1.	training_en
B0AT1 may become a therapeutic target for drug screening to suppress SARS-CoV-2 infection.	B0AT1 potrebbe diventare un bersaglio terapeutico per lo studio di farmaci per sopprimere l’infezione da SARS-CoV-2.	training_en
The origin and immediate host	L'origine e l'ospite immediato	training_en
However, what intermediate host helped the virus cross the species barrier to infect humans remains unknown, and the transmission route is yet to be elucidated.	Tuttavia, resta da chiarire quale ospite intermedio abbia aiutato il virus ad attraversare la barriera di specie per infettare gli umani, e la via di trasmissione.	training_en
According to a study, researchers in Guangzhou, China, suggested that pangolins – long-snouted, ant-eating mammals often used in traditional Chinese medicine – are the potential intermediate host of SARS-CoV-2 based on 99% genetic homology in a CoV discovered in pangolins and SARS-CoV-2.	Uno studio condotto da dei ricercatori di Guangzhou, in Cina, suggerisce che i pangolini - mammiferi dal muso lungo mangiatori di formiche usati spesso nella medicina tradizionale cinese - siano i potenziali ospiti intermedi del SARS-CoV-2 sulla base di un’omologia del 99% in un CoV scoperto nei pangolini e nel SARS-CoV-2.	training_en
However, 1% difference spread all over two genomes is still a big difference; thus, conclusive results for concrete evidence are awaited (Fig. 3).	Tuttavia, una differenza dell’1% distribuita su due genomi resta ancora una grossa differenza; pertanto, si attendono risultati conclusivi per prove concrete (Fig. 3).	training_en
SARS-CoV-2 may possess similar properties.	Il SARS-CoV-2 potrebbe possedere proprietà simili.	training_en
The entire human population generally lacks immunity to SARS-CoV-2 and hence is susceptible to the novel virus.	In generale, l’intera popolazione umana è priva di immunità al SARS-CoV-2, ed è quindi suscettibile al nuovo virus.	training_en
Currently, no detailed study has been reported regarding the immunological response to SARS-CoV-2.	Al momento, non si ha notizia di alcuno studio dettagliato sulla risposta immunologica al SARS-CoV-2.	training_en
Through different pathways, the virus induces the expression of inflammatory factors, maturation of dendritic cells, and synthesis of type I interferons (IFNs) which limit the spreading of the virus and accelerate macrophage phagocytosis of viral antigens.	Attraverso diverse vie, il virus induce l’espressione di fattori infiammatori, la maturazione di cellule dendritiche, e la sintesi di interferoni di tipo I (IFN), i quali limitano il diffondersi del virus e accelerano la fagocitosi macrofagica degli antigeni virali.	training_en
Soon, the adaptive immune response joins the fight against the virus.	Presto, la risposta immunitaria adattativa si unisce alla lotta contro il virus.	training_en
T lymphocytes including CD4+ and CD8+ T cells play an important role in the defense.	I linfociti T, inclusi i linfociti T CD4+ e CD8+, ricoprono un ruolo importante nella difesa.	training_en
However, CoV can inhibit T cell functions by inducing apoptosis of T cells.	Tuttavia, i CoV possono inibire le funzioni dei linfociti T inducendo l’apoptosi dei linfociti T.	training_en
For example, antibodies isolated from a recovered patient neutralized MERS-CoV.	Ad esempio, gli anticorpi isolati da un paziente guarito hanno neutralizzato il MERS CoV.	training_en
On the other hand, an overreaction of the immune system generates a large number of free radicals locally that can cause severe damages to the lungs and other organs, and, in the worst scenario, multi-organ failure and even death.	D’altro canto, una reazione eccessiva del sistema immunitario genera localmente un grande numero di radicali liberi che può causare danni gravi ai polmoni e ad altri organi, e, nello scenario peggiore, insufficienza multiorgano e perfino il decesso.	training_en
The estimated mean incubation period of SARS-CoV-2 is 1-14 days, mostly 3-7 days based on a study of the first 425 cases in Wuhan.	Il periodo di incubazione medio stimato del SARS-CoV-2 è 1-14 giorni, per lo più 3-4 giorni in base a uno studio dei primi 425 casi a Wuhan.	training_en
A more recent study, as described above, demonstrates that the incubation period was 4.8 (3.0-7.2) days based on the demography of 8,866 cases.	Uno studio più recente, come descritto in precedenza, dimostra che il periodo di incubazione era di 4,8 (3,0-7,2) giorni in base alla demografia di 8,866 casi.	training_en
It is very important for health authorities to adjust the effective quarantine time based on the most accurate incubation period, thus preventing infected but symptomless people from transmitting the virus to others.	È molto importante che le autorità sanitarie calibrino il periodo di quarantena effettivo sulla base del periodo di incubazione più accurato, impedendo così alle persone infette ma asintomatiche dal trasmettere il virus ad altri.	training_en
Fever is often the major and initial symptom of COVID-19, which can be accompanied by no symptom or other symptoms such as dry cough, shortness of breath, muscle ache, dizziness, headache, sore throat, rhinorrhea, chest pain, diarrhea, nausea, and vomiting.	La febbre è spesso il sintomo principale e iniziale del COVID-19, che può essere accompagnato da nessun sintomo o da altri sintomi come tosse secca, fiato corto, dolori muscolari, vertigini, mal di testa, mal di gola, rinorrea, dolori al torace, diarrea, nausea e vomito.	training_en
In severe cases, patients quickly progressed to develop acute respiratory syndrome, septic shock, metabolic acidosis, and coagulopathy.	In casi gravi, i pazienti hanno rapidamente proceduto a sviluppare sindrome respiratoria acuta, shock settico, acidosi metabolica e coagulopatie.	training_en
Patients with fever and/or respiratory symptoms and acute fever, even without pulmonary imaging abnormalities, should be screened for the virus for early diagnosis.	I pazienti con febbre e/o sintomi respiratori e febbre acuta, anche senza anomalie nell’imaging polmonare, dovrebbero sottoporsi a un esame per il virus per una diagnosi precoce.	training_en
Comparably, a demographic study in 2012 showed that MERS-CoV patients also had fever (98%), dry cough (47%), and dyspnea (55%) as their main symptoms.	Analogamente, uno studio di popolazione condotto nel 2012 ha mostrato che anche i pazienti MERS-CoV presentavano febbre (98%), tosse secca (47%), e dispnea (55%) come sintomi principali.	training_en
Diarrhea (26%) and sore throat (21%) were also observed with MERS patients.	Anche la diarrea (26%) e il mal di gola (21%) sono stati osservati in pazienti MERS.	training_en
In SARS patients, it has been demonstrated that fever (99%-100%), dry cough (29%-75%), dyspnea (40%-42%), diarrhea (20-25%), and sore throat (13-25%) were the major symptoms and ventilation support was required for approximately 14%-20% of the patients.	Nei pazienti SARS, è stato dimostrato che febbre (99%-199%), tosse secca (29%-75%), dispnea (40%-42%), diarrea (20-25%), e mal di gola (13-25%) erano i sintomi principali e il supporto della ventilazione era richiesto per circa il 14%-20% dei pazienti.	training_en
For MERS, based on a demographic study in June 2012, the mortality was 37% of 2,494 confirmed cases.	Per la MERS, in base a uno studio di popolazione del giugno 2012, la mortalità era del 37% dei 2.494 casi confermati.	training_en
A comparison of SARS-CoV-2 with MERS-CoV and SARA-CoV regarding their symptoms, mortality, and R0 is presented in Table 1.	Un confronto tra SARS-CoV-2, MERS-CoV e SARS-CoV rispetto ai loro sintomi, alla mortalità e all’R0 è presentato nella Tabella 1.	training_en
The above figures suggest that SARS-CoV-2 has a higher ability to spread than MERS-CoV and SARS-CoV, but it is less lethal than the latter two.	Le cifre di cui sopra suggeriscono che il SARS-CoV-2 abbia un’abilità maggiore di diffondersi rispetto al MERS-CoV e il SARS-CoV, ma che è meno letale di questi ultimi due.	training_en
Patients often have a history of travel or residence in Wuhan or other affected areas or contact with infected individuals or patients in the recent two weeks before the onset.	I pazienti hanno spesso una storia di viaggi o residenza a Wuhan o in altre aree colpite, oppure di contatto con individui o pazienti infetti nelle ultime due settimane precedenti all’esordio.	training_en
Patients have normal or reduced number of peripheral white blood cells (especially lymphocytes) at the early stage.	Nella fase iniziale i pazienti presentano un numero normale o ridotto di globuli bianchi del sangue periferico (in particolare i linfociti).	training_en
For example, lymphopenia with white blood cell count < 4×109/L including lymphocyte count < 1×109/L, and elevated aspartate aminotransferase levels and viremia were found in 1,099 COVID-19 patients.	Per esempio, in 1.099 pazienti COVID-19 sono stati rilevati linfocitopenia con un valore dei globuli bianchi < 4×109/L, incluso un valore dei linfociti < 1×109/L, e livelli elevati di aspartato aminotransferasi e viremia.	training_en
Abnormalities in chest radiography are found in most COVID-19 patients and featured by bilateral patchy shadows or ground glass opacity in the lungs.	Nella maggior parte dei pazienti COVID-19 si riscontrano anomalie nella radiografia toracica, caratterizzate da ombre irregolari o da opacità a vetro smerigliato bilaterali nei polmoni.	training_en
When ARDS happens, uncontrolled inflammation, fluid accumulation, and progressive fibrosis severely compromise the gas exchange.	Quando si verifica la ARDS, l’infiammazione incontrollata, l’accumulo di fluidi e la fibrosi progressiva compromettono gravemente lo scambio gassoso.	training_en
Dysfunction of type-I and type-II pneumocytes decreases the surfactant level and increases surface tension, thus reducing the ability of the lungs to expand and heightening the risk of lung collapse.	Le disfunzioni degli pneumociti di tipo I e II riducono il livello di surfattante e aumentano la tensione superficiale, riducendo così la capacità dei polmoni di espandersi e aumentando il rischio di collasso polmonare.	training_en
The detection of SARS-CoV-2 RNA via reverse-transcriptase polymerase chain reaction (RT-PCR) was used as the major criteria for the diagnosis of COVID-19.	La rilevazione dell’RNA del SARS-CoV-2 tramite reazione a catena della polimerasi inversa (RT-PCR) è stata usata come criterio principale per la diagnosi di COVID-19.	training_en
A similar situation also occurred with the diagnosis of SARS.	Una situazione simile si è verificata anche con la diagnosi della SARS.	training_en
Therefore, a combination of disease history, clinical manifestations, laboratory tests, and radiological findings is essential and imperative for making an effective diagnosis.	Pertanto, una combinazione di anamnesi, manifestazioni cliniche, test di laboratorio, risultati radiologici è essenziale e imperativa per effettuare una diagnosi efficace.	training_en
Due to the lack of experience with the novel CoV, physicians can mainly provide supportive care to COVID-19 patients, while attempting a variety of therapies that have been used or proposed before for the treatment of other CoVs such as SARS-CoV and MERS-CoV and other viral diseases (Table 2).	Per via della mancanza di esperienza con il nuovo CoV, i medici possono fornire principalmente terapie di supporto ai pazienti COVID-19, mentre provano una serie di terapie che sono state usate o proposte in precedenza per il trattamento di altri CoV come il SARS-CoV e il MERS CoV e altre malattie virali (Tabella 2).	training_en
Even plasma from recovered patients was proposed to be used for treatment.	Si è perfino proposto di adoperare, per il trattamento, il plasma di pazienti guariti.	training_en
Pharmaceutical companies are racing to develop antibodies and vaccines against the virus.	Le compagnie farmaceutiche stanno concorrendo per sviluppare anticorpi e vaccini contro il virus.	training_en
Thus, respiratory support is critical to relieve the symptoms and save lives and includes general oxygen therapy, high-flow oxygen, noninvasive ventilation, and invasive mechanical ventilation depending on the severity of the disease.	Il supporto respiratorio è dunque cruciale per alleviare i sintomi e salvare vite, e include l’ossigenoterapia generale, l’ossigeno ad alto flusso , la ventilazione non invasiva e la ventilazione invasiva meccanica a seconda della gravità della malattia.	training_en
In addition, the maintenance of electrolyte balance, the prevention and treatment of secondary infection and septic shock, and the protection of the functions of the vital organs are also essential for SARS-CoV-2 patients.	Inoltre, il mantenimento dell’equilibrio degli elettroliti, la prevenzione e la cura dell’infezione secondaria e dello shock settico, e la protezione delle funzioni degli organi vitali sono anch’essi essenziali per i pazienti di SARS-CoV-2.	training_en
It has been known that a cytokine storm results from an overreaction of the immune system in SARS and MERS patients.	È risaputo che una tempesta di citochine deriva da una reazione eccessiva del sistema immunitario nei pazienti SARS e MERS.	training_en
Immunosuppression is essential in the treatment of cytokine storms, especially in severe patients.	L’immunosoppressione è essenziale nel trattamento delle tempeste di citochine, specialmente nei pazienti gravi.	training_en
Other immunosuppression treatments for cytokine storm include the modulation of T cell-directed immune response; the blockade of IFN-γ, IL-1, and TNF; JAK inhibition ; blinatumomab ; suppressor of cytokine signaling 4 ; and HDAC inhibitors.	Altri trattamenti immunosoppressivi per le tempeste di citochine comprendono la modulazione della risposta immunitaria diretta dai linfociti T, il blocco di IFN-γ, IL-1, e TNF; l’inibizione di JAK ; il blintumoab ; i soppressori della segnalazione di citochine 4 ; e gli inibitori di HDAC.	training_en
Steroids, as immunosuppressants, were widely used in the treatment of SARS to reduce the severity of inflammatory damage.	Gli steroidi, in quanto immunosoppressori, sono stati ampiamente usati nel trattamento della SARS per ridurre la gravità dei danni infiammatori.	training_en
Nevertheless, short courses of corticosteroids at low-to-moderate doses have been recommended to be used prudently for critically ill COVID-19 patients.	Ciononostante, è stato raccomandato l’uso prudente di brevi cicli di corticosteroidi in dosi da basse a moderate per i pazienti COVID-19 in condizioni critiche.	training_en
However, intravenous administration with remdesivir, a nucleotide analog, has been found to be efficacious in an American patient with COVID-19.	Tuttavia, l'infusione endovenosa di remdesivir, un analogo nucleotidico, si è rivelata efficace in un paziente americano affetto da COVID-19.	training_en
Remdesivir is a novel antiviral drug developed by Gilead initially for the treatment of diseases caused by Ebola and Marlburg viruses.	Il remdesivir è un nuovo farmaco antivirale inizialmente sviluppato da Gilead per il trattamento delle malattie provocate dai virus Ebola e di Marlburg.	training_en
In addition, baricitinb, interferon-α, lopinavir/ritonavir, and ribavirin have been suggested as potential therapies for patients with acute respiratory symptoms.	Inoltre, il baricitinb, l'interferone-α, il lopinavir/ritonavir e la ribavirina sono stati suggeriti come potenziali terapie per pazienti con sintomi respiratori acuti.	training_en
The interaction of these treatments with other drugs used in the patients should be monitored carefully.	L’interazione di questi trattamenti con altri farmaci nei pazienti deve essere monitorata attentamente.	training_en
Plasma from recovered patients and antibody generation	Plasma proveniente da pazienti guariti e generazione di anticorpi	training_en
Antibodies are an immunoglobulin (Ig) produced by B lymphocytes to fight pathogens and other foreign objects and they recognize unique molecules in the pathogens and neutralize them directly.	Gli anticorpi sono immunoglobuline (Ig) prodotte dai linfociti B per combattere i patogeni e altri oggetti estranei, e riconoscono molecole uniche all’interno dei patogeni, neutralizzandole in modo diretto.	training_en
Their symptoms improved within 24 hours, accompanied by reduced inflammation and viral loads and improved oxygen saturation in the blood.	I loro sintomi sono migliorati in 24 ore, e hanno registrato inoltre una riduzione dell’infiammazione e delle cariche virali e una migliore saturazione dell’ossigeno nel sangue.	training_en
However, verification and clarification are necessary to propose the method for large-scale use before specific therapies are not yet developed.	Tuttavia, fino a quando non verranno sviluppate terapie specifiche, è necessario che questi risultati siano verificati e chiariti per affinché il metodo sia proposto per un uso su larga scala.	training_en
The concentration of antibodies in the blood is usually low, and the demand for the plasma is large to treat critically ill patients.	La concentrazione di anticorpi nel sangue è solitamente bassa, e la richiesta del plasma è alta per trattare pazienti in condizioni critiche.	training_en
Thus, it is more critical and practical to isolate B cells from recovered patients and identify the genetic codes encoding effective antibodies or screen for effective antibodies against essential proteins of the virus.	Pertanto, è più importante e pratico isolare i linfociti B dai pazienti guariti e identificare i codici genetici che codificano anticorpi efficaci o effettuare controlli per anticorpi efficaci contro le proteine essenziali del virus.	training_en
This way, we can readily scale up the production of the antibodies.	In questo modo, è possibile aumentare gradualmente la produzione degli anticorpi.	training_en
Most of the effective components remain unknown or are vague as it is difficult to extract and verify such components or their optimal combinations.	La maggior parte delle componenti efficaci rimane sconosciuta o risulta vaga, poiché è difficile estrarre e verificare tali componenti o le loro combinazioni ottimali.	training_en
For example, Shu Feng Jie Du capsules and Lian Hua Qing Wen capsules were found to be effective for COVID-19 treatment.	Per esempio, è stato riscontrato che le capsule Shu Feng Jie Du e le capsule di Lian Hua Qing Wen sono efficaci per il trattamento del COVID-19.	training_en
Top cure rates in the treatment of COVID-19 patients were observed in several provinces in China that used TCM in 87% of their patients, including Gansu (63.7%), Ningxia (50%), and Hunan (50%), whereas Hubei province, which used TCM in only approximately 30% of its COVID-19 patients, had the lowest cure rate (13%).	I migliori tassi di cura nel trattamento dei pazienti COVID-19 sono stati osservati in alcune province in Cina che usavano la MTC sull’87% dei propri pazienti, incluse Gansu (63,7%), Ningxia (50%) e Hunan (50%), mentre la provincia dello Hubei, che usava la MTC solo su circa il 30% dei suoi pazienti COVID-19, aveva il tasso di cura più basso (13%).	training_en
They found that the times needed for body temperature recovery, symptom disappearance, and hospitalization were remarkably shorter in the WM+TCM group than in the WM only group.	Hanno riscontrato che i tempi necessari per l'abbassamento della temperatura corporea, la sparizione dei sintomi e l’ospedalizzazione erano considerevolmente più brevi nel gruppo MO+MTC che nel gruppo con solo MO.	training_en
Nevertheless, the efficacy and safety of TCM still await more well-controlled trials at larger scales and in more centers.	Ciononostante, l’efficacia e la sicurezza della MTC sono ancora in attesa di sperimentazioni ben controllate su larga scala e in più centri.	training_en
It would also be intriguing to characterize the mechanism of actions and clarify the effective components of TCM treatments or their combinations if possible.	Altrettanto interessante sarebbe caratterizzare il meccanismo delle azioni e chiarire le componenti efficaci dei trattamenti della MTC o delle loro combinazioni, se possibile.	training_en
In the early phase of the SARS outbreak, a range of psychiatric morbidities including persistent depression, anxiety, panic attacks, psychomotor excitement, psychotic symptoms, delirium, and even suicidality were reported.	Nella prima fase dell’epidemia di SARS sono state riscontrate una serie di morbilità psichiatriche, tra cui depressione persistente, ansia, attacchi di panico, agitazione psicomotoria, sintomi psicotici, delirio e perfino ideazione suicidaria.	training_en
Thus, mental health care should be provided to COVID-19 patients, suspected individuals, and people in contact with them as well as the general public who are in need.	Pertanto, si dovrebbe offrire assistenza per la salute mentale ai pazienti COVID-19, agli individui con casi sospettati e le persone a contatto con loro, così come al pubblico in generale che ne ha bisogno.	training_en
The psychological support should include the establishment of multidisciplinary mental health teams, clear communications with regular and accurate updates about the SARS-CoV-2 outbreak and treatment plans and the use of professional electronic devices and applications to avoid close contact with each other.	Il supporto psicologico dovrebbe includere l’istituzione di team multidisciplinari di salute mentale, comunicazioni chiare con aggiornamenti regolari e puntuali sull’epidemia di SARS-CoV-2,sui suoi piani di cura e sull’uso di dispositivi elettronici professionali e applicazioni per evitare contatti ravvicinati.	training_en
Live-attenuated vaccines have been evaluated in animal models for SARS.	Sono stati valutati vaccini vivi attenuati in modelli animali per la SARS.	training_en
This is probably because SARS died down 17 years ago and no new case has been reported since.	Questo è probabilmente dovuto al fatto che la SARS si è estinta 17 anni fa e da allora non è stato registrato alcun nuovo caso.	training_en
In contrast, sporadic cases and clusters of MERS continue to occur in the Middle East and spread to other regions owing to the persistence of zoonotic sources in endemic areas.	Al contrario, casi sporadici e cluster di MERS continuano a verificarsi in Medio Oriente e a diffondersi in altre regioni per via della persistenza di fonti zoonotiche in aree endemiche.	training_en
However, it is challenging to overcome the difficulty because of the long period of time (averaged 18 months) needed for vaccine development and the dynamic variations of CoVs.	Tuttavia, è difficile superare questa difficoltà a causa del lungo periodo di tempo (18 mesi in media) necessario per lo sviluppo di un vaccino e delle variazioni dinamiche dei CoV.	training_en
In most cases, patients can recover gradually without sequelae.	Nella maggioranza dei casi, i pazienti possono guarire gradualmente senza sequele.	training_en
However, similar to SARS and MERS, COVID-19 is also associated with high morbidity and mortality in patients with severe cases.	Tuttavia, analogamente alla SARS e alla MERS, il COVID-19 è anche associato ad alte morbilità e mortalità nei pazienti con casi gravi.	training_en
Age: Age was the most important factor for the prognosis of SARS , which is also true for COVID-19.	Età: L'età era il fattore più importante per la prognosi della SARS , il che è anche vero per il COVID-19.	training_en
Patients who required intensive care were more likely to have underlying comorbidities and complications and were significantly older than those who did not (at the median age of 66 versus 51) , suggesting age as a prognostic factor for the outcome of COVID-19 patients.	I pazienti che necessitavano cure intensive avevano più probabilità di presentare comorbilità pregresse e complicanze, ed erano sensibilmente più anziani di chi non ne aveva (all’età mediana di 66 anni contro 51) , il che suggerisce che l’età sia un fattore pronostico per l’esito dei pazienti COVID-19.	training_en
Sex: SARS-CoV-2 has infected more men than women (0.31/100,000 versus 0.27/100,000), as described above.	Sesso: Il SARS-CoV-2 ha infettato più gli uomini che le donne (0,31/100.000 contro 0,27/100.000), come descritto in precedenza.	training_en
It has been reported that SARS-CoV-2 can also bind to ACE2-positive cholangiocytes, which might lead to liver dysfunctions in COVID-19 patients.	È stato riscontrato che il SARS-CoV-2 può anche legarsi ai colangiociti positivi ad ACE2, il che potrebbe portare a disfunzioni epatiche nei pazienti COVID-19.	training_en
Abnormal laboratory findings: The C-reactive protein (CRP) level in blood reflects the severity of inflammation or tissue injury and has been proposed to be a potential prognostic factor for disease, response to therapy, and ultimate recovery.	Risultati di laboratorio anomali: Il livello di proteina C reattiva (CRP) nel sangue riflette la gravità dell’infiammazione o dei danni ai tessuti ed è stato proposto come potenziale fattore di prognosi per la malattia, la risposta alla terapia e la guarigione finale.	training_en
The correlation of CRP level to the severity and prognosis of COVID-19 has also been proposed.	È stata proposta anche la correlazione del livello di CRP alla gravità e alla prognosi del COVID-19.	training_en
Thus, they are traditional markers for heart or liver dysfunctions.	Pertanto, essi sono marcatori tradizionali di disfunzioni cardiache o epatiche.	training_en
Use of steroids: As described above, steroids are immunosuppressant commonly used as an adjunctive therapy for infectious diseases to reduce the severity of inflammatory damage.	Uso di steroidi: Come descritto in precedenza, gli steroidi sono immunosoppressori comunemente usati come terapia aggiuntiva per le malattie infettive al fine di ridurre la gravità dei danni infiammatori.	training_en
Since a high dosage of corticosteroids was widely used in severe SARS patients, many survivors suffered from avascular osteonecrosis with life-long disability and poor life quality.	Siccome una dose elevata di corticosteroidi è stata ampiamente usata nei pazienti SARS gravi, molti sopravvissuti hanno sviluppato osteonecrosi avascolare, con disabilità permanenti e scarsa qualità della vita.	training_en
It is imperative to provide psychological counseling and long-term support to help these patients recover from the stress and return to normal life.	È necessario fornire consulenza psicologica e supporto nel lungo termine per aiutare questi pazienti a guarire dallo stress e tornare alla vita normale.	training_en
In addition to replicating in the lower respiratory tract, SARS-CoV-2 can efficiently replicate in the upper respiratory tract and causes mild or no symptoms in the early phase of infection, similar to other CoVs that cause common colds.	Oltre a riprodursi nel tratto respiratorio inferiore, il SARS-CoV-2 può replicarsi efficacemente nel tratto respiratorio superiore e provoca sintomi moderati o non causa alcun sintomo nella prima fase dell’infezione, analogamente ad altri CoV che provocano raffreddori comuni.	training_en
Therefore, infected patients at the early phase or incubation period can produce a large amount of virus during daily activities, causing great difficulty for the control of the epidemic.	Pertanto, nella prima fase o nel periodo di incubazione i pazienti infetti possono produrre una vasta quantità di virus durante le attività quotidiana, causando una notevole difficoltà per il controllo dell’epidemia.	training_en
Great efforts are currently underway in China including the lockdown of Wuhan and surrounding cities and continuous quarantine of almost the entire population in hopes of interrupting the transmission of SARS-CoV-2.	Al momento sono in corso grandi sforzi in Cina che includono la chiusura di Wuhan e altre città circostanti e la quarantena continua della quasi totalità della popolazione, nella speranza di interrompere la trasmissione del SARS-CoV-2.	training_en
The most optimistic estimate is that the outbreak will end by March and the downswing phase will last for 3-4 months.	La stima più ottimista prevede che l’epidemia si concluderà entro marzo e che la fase di ridimensionamento durerà per 3-4 mesi.	training_en
However, some other experts are not that optimistic.	Tuttavia, alcuni altri esperti non sono così ottimisti.	training_en
A Canadian group reported that SARS-CoV-2 was detected in both mid-turbinate and throat swabs of patients who recovered and left the hospital 2 weeks earlier , which indicates that the newly identified virus could become a cyclical episode similar to influenza.	Un gruppo canadese ha riscontrato che il SARS-CoV-2 è stato rilevato sia in tamponi nasali che faringei di pazienti guariti che avevano lasciato l’ospedale due settimane prima , che indica che il nuovo virus identificato potrebbe diventare un episodio ciclico simile all’influenza.	training_en
Ebola was originally predicted to cause up to a million cases with half a million deaths.	In origine si prevedeva che l’Ebola avrebbe causato fino a un milione di casi con mezzo milione di decessi.	training_en
However, via strict quarantine and isolation, the disease has eventually been put under control.	Tuttavia, grazie a una quarantena e un isolamento rigorosi, la malattia è stata infine messa sotto controllo.	training_en
SARS-CoV-2 is highly transmittable through coughing or sneezing, and possibly also through direct contact with materials contaminated by the virus.	Il SARS-CoV-2 è altamente trasmissibile attraverso la tosse o gli starnuti, e probabilmente anche attraverso il contatto diretto con materiali contaminati dal virus.	training_en
A recent study on 138 cases reported that 41% of the cases were possibly caused by nosocomial infections, including 17 patients with other prior diseases and 40 health-care providers.	Uno studio recente su 138 pazienti ha riscontrato che il 41% dei casi è stato probabilmente causato da infezioni nosocomiali, tra cui 17 pazienti con altre patologie pregresse e 40 fornitori di cure mediche.	training_en
Thus, great precaution should be used to protect humans, especially health-care providers, social workers, family members, colleagues, and even bystanders in contact with patients or infected people.	Pertanto, bisognerebbe usare grande precauzione per proteggere gli esseri umani, specialmente i fornitori di cure mediche, i lavoratori sociali, parenti, colleghi e perfino i passanti a contatto con pazienti o persone infette.	training_en
The first line of defense that could be used to lower the risk of infection is through wearing face masks; both the use of surgical masks and N95 respirator masks (series # 1860s) helps control the spread of viruses.	La prima linea di difesa che può essere usata per diminuire il rischio di infezione è indossare le mascherine per il viso; l’uso di mascherine, sia chirurgiche che con respiratore N95 (numero di serie 1860), aiuta a controllare la diffusione dei virus.	training_en
Surgical face masks prevent liquid droplets from a potentially infected individual from traveling through the air or sticking onto surfaces of materials, where they could be passed on to others.	Le mascherine chirurgiche impediscono che le goccioline liquide da un individuo potenzialmente infetto si trasmettano nell’aria o aderiscano alle superfici dei materiali, dove potrebbero essere trasmesse ad altri.	training_en
However, only N95 (series # 1860s) masks can protect against the inhalation of virions as small as 10 to 80 nm, with only 5% of the virions being able to penetrate completely; SARS-CoV-2 is similar to SARS-CoV in size and both are approximately 85 nm.	Tuttavia, solo le mascherine N95 (numero di serie 1860) possono proteggere dall’inalazione di virioni compresi tra i 10 e gli 80 nm, con solo il 5% dei virioni in grado di penetrare completamente; il SARS-CoV-2 è simile per dimensioni al SARS-CoV ed entrambi misurano circa 85 nm.	training_en
Since particles can penetrate even five surgical masks stacked together, health-care providers in direct contact with patients must wear N95 (series # 1860s) masks but not surgical masks.	Siccome le particelle possono penetrare perfino cinque mascherine chirurgiche impilate tra loro, i fornitori di cure mediche a contatto diretto con i pazienti dovrebbero indossare le mascherine N95 (numero di serie 1860) ma non quelle chirurgiche.	training_en
In addition to masks, health-care providers should wear fitted isolation gowns in order to further reduce contact with viruses.	Oltre alle mascherine, i fornitori di cure mediche dovrebbero indossare camici isolanti su misura per ridurre ulteriormente il contatto con i virus.	training_en
Viruses can also infect an individual through the eyes.	I virus possono infettare un individuo attraverso gli occhi.	training_en
On January 22, 2020, a doctor was infected with SARS-CoV-2 although he wore an N95 mask; the virus might have entered his body through his inflammatory eyes.	Il 22 gennaio 2020, un medico è stato infettato dal SARS-CoV-2 nonostante indossasse una mascherina N95; il virus potrebbe avere fatto ingresso nel suo corpo attraverso i suoi occhi infiammati.	training_en
Thus, health-care providers should also wear transparent face shields or goggles while working with patients.	Pertanto, i fornitori di cure mediche dovrebbero indossare schermi facciali trasparenti o occhiali protettivi mentre lavorano con i pazienti.	training_en
For the general public in affected or potentially affected areas, it is highly suggested that everybody wash their hands with disinfectant soaps more often than usual, try to stay indoors for self-quarantine and limit contact with potentially infected individuals.	Alla popolazione delle aree colpite o potenzialmente colpite si consiglia vivamente di lavarsi le mani con saponi disinfettanti più spesso del solito, di cercare di restare in casa in autoquarantena e limitare i contatti con individui potenzialmente infetti.	training_en
Three feet is considered an appropriate distance for people to stay away from a patient.	Affinché le persone si mantengano lontane da un paziente, un metro è considerato una distanza adeguata.	training_en
These actions are effective methods to lower the risk of infection as well as prevent the spread of the virus.	Queste azioni sono metodi efficaci per diminuire il rischio di infezione ed impedire la diffusione del virus.	training_en
Although SARS-CoV-2 came as a new virus to the human world, its high homology to SARS-CoV as reported on 7 January 2020 should have caused high alert to China based on her deep memory of the SARS outbreak in 2003.	Sebbene il SARS-CoV-2 sia comparso come nuovo virus nel mondo umano, la sua alta omologia al SARS-CoV come riferito il 7 gennaio 2020 avrebbe dovuto provocare grande allarme alla Cina per via della sua esperienza con l’epidemia di SARS del 2003.	training_en
However, not until 19 January 2020 did the director of the Center of Disease Control of Wuhan comfort the citizens by saying that the novel virus has low contagiousness and limited reproductivity from human to human and that it is not a problem to prevent and contain the disease.	Eppure, fino al 19 gennaio 2020 il direttore del Centro per il Controllo delle Malattie di Wuhan ha rassicurato i cittadini dicendo che il nuovo virus aveva una bassa contagiosità e una riproduttività limitata da uomo a uomo e che non sarebbe stato un problema prevenire e arginare la malattia.	training_en
This message remarkably relaxed the alarm of the public, especially when the entire country was preparing for the Spring Festival, and the critical time was missed to contain the disease at its minimal scale in Wuhan.	Questo messaggio ha allentato considerevolmente l'attenzione della popolazione, specialmente in un momento in cui l’intero Paese si stava preparando per la festa di primavera, e ha perso il periodo critico per contenere la malattia su scala ridotta a Wuhan.	training_en
The disease control agencies in China may take this hard lesson and make critical improvements in the future.	Le agenzie per il controllo delle malattie in Cina dovrebbero apprendere questa dura lezione e adottare miglioramenti decisivi in futuro.	training_en
The outbreak of COVID-19 caused by the novel virus SARS-CoV-2 started in the end of December 2019.	L’epidemia di COVID-19 provocata dal nuovo coronavirus SARS-CoV-2 ha avuto inizio alla fine del dicembre 2019.	training_en
In less than two months, it has spread all over China and near 50 other countries globally at the time of this writing.	In meno di due mesi, si è diffusa in tutta la Cina e quasi altri 50 Paesi a livello globale al momento della stesura di questo articolo.	training_en
Since the virus is very similar to SARS-CoV and the symptoms are also similar between COVID-19 and SARS, the outbreak of COVID-19 has created a sense of SARS recurring.	Siccome il virus è molto simile al SARS-CoV e anche i sintomi sono molto simili tra il COVID-19 e la SARS, l’epidemia di COVID-19 ha creato una sensazione di risorgenza della SARS.	training_en
However, there are some remarkable differences between COVID-19 and SARS, which are essential for containing the epidemic and treating the patients.	Tuttavia, ci sono delle differenze considerevoli tra il COVID-19 e la SARS, che sono essenziali per arginare l’epidemia e curare i pazienti.	training_en
COVID-19 affects more elderly individuals than youth and more men than women, and the severity and death rate are also higher in elderly individual than in youth.	Il COVID-19 colpisce più gli anziani che i giovani e più gli uomini che le donne, e anche la gravità e il tasso di mortalità sono più alte negli anziani che nei giovani.	training_en
SARS has higher mortality than COVID-19 (10.91% versus 1.44%).	La SARS ha una mortalità più alta del COVID-19 (10,91% contro 1,44%).	training_en
COVID-19 patients transmit the virus even when they are symptomless whereas SARS patients do so usually when they are severely ill, which causes much greater difficulty to contain the spread of COVID-19 than SARS.	I pazienti COVID-19 trasmettono il virus anche quando asintomatici, mentre i pazienti SARS lo fanno solo se gravemente malati, il che provoca una maggiore difficoltà ad arginare la diffusione del COVID-19 rispetto a quella della SARS.	training_en
This partially explains why SARS-CoV-2 spread much faster and broader than SARS-CoV.	Questo spiega in parte come mai il SARS-CoV-2 si diffonda molto più rapidamente e largamente del SARS-CoV.	training_en
The regular RNA assay for SARS-CoV-2 can be negative in some COVID-19 patients.	L’analisi regolare dell’RNA per il SARS-CoV-2 può risultare negativa in alcuni pazienti COVID-19.	training_en
On the other hand, cured patients can be positive for the virus again.	D’altro canto, i pazienti curati possono tornare ad essere positivi al virus.	training_en
These findings dramatically increase the risk of virus spreading.	Questi risultati aumentano sensibilmente il rischio di diffusione del virus.	training_en
Given such rapid progress in research on COVID-19, several critical issues remain to be solved, as follows:	Visti i progressi così rapidi della ricerca sul COVID-19, restano da risolvere alcuni problemi cruciali, come i seguenti:	training_en
Where did SARS-CoV-2 come from?	Da dove è venuto il SARS-CoV-2?	training_en
Although 96% genetic homolog was found between SARS-CoV-2 and two bat SARS-like CoVs, we still cannot conclude that SARS-CoV-2 is from bats.	Sebbene un omologo genetico del 96% sia stato trovato tra il SARS-CoV-2 e i due CoV dei pipistrelli simili al SARS, non si può ancora concludere che il SARS-CoV-2 venga dai pipistrelli.	training_en
What animal was the intermediate species to transmit the virus from the original host, say bats, to humans?	Quale animale è stata la specie intermedia che ha trasmesso il virus dall’ospite originario, supponiamo i pipistrelli, agli esseri umani?	training_en
Without knowing answers to #1 and 2, we cannot efficiently cut the transmission, and the outbreak can relapse at any time.	Senza conoscere le risposte alla numero 1 e 2, non si può interrompere la trasmissione in modo efficace, e l’epidemia può riemergere in ogni momento.	training_en
Although molecular modeling and biochemical assays have demonstrated that SARS-CoV-2 binds to ACE2, how exactly does the virus enter the airway cells and cause subsequent pathological changes?	Sebbene la modellazione molecolare e le analisi biochimiche abbiano dimostrato che il SARS-CoV-2 si lega ad ACE2, in che modo esattamente il virus entra nelle cellule aeree e causa i cambiamenti patologici successivi?	training_en
Does the virus also bind ACE2-expressing cells in other organs?	Il virus si lega anche alle cellule che esprimono ACE2 in altri organi ?	training_en
Without clear answers to these questions, we cannot achieve fast and accurate diagnosis and effective treatment.	Senza delle risposte chiare a queste domande, non è possibile ottenere una diagnosi rapida e accurata e un trattamento efficace.	training_en
How is the virus genetically evolving during transmission among humans?	Come si evolve geneticamente il virus durante la trasmissione fra gli esseri umani?	training_en
Will it become a pandemic worldwide, die down like SARS or relapse periodically like the flu?	Diventerà una pandemia globale, si estinguerà come la SARS o riemergerà periodicamente come l’influenza?	training_en
It is essential but may take some time to search for answers to the above and many other questions.	Cercare le risposte a queste e a molte altre domande è fondamentale, ma potrebbe richiedere del tempo.	training_en
However, with whatever expense it may demand, we have no other choice but to stop the epidemic as soon as possible and bring our life back to normal.	Tuttavia, non c’è altra scelta se non quella di fermare l’epidemia il prima possibile e riportare le nostre vite alla normalità, costi quel che costi.	training_en